1111111111
1001100111
1100000011
1001110001
1011100001
1000000111
1011100001
1000100011
1000100011
1111111111